0001111111111111
1101111111111111
1100011111111111
1111011111111111
1111000111111111
1111110111111111
1111110001111111
1111111101111111
1111111100011111
1111111111011111
1111111111000111
1111111111110111
1111111111110001
1111111111111101
1111111111111100
1111111111111110
