1100101000110101
1001000011010011
1001101000100101
1101000010101101
1010110101001011
1010100101110101
1110101111000001
1010001011101011
1011010001000101
1110000110110111
1000110110010001
1011001001101011
1000010110110101
1110110101111011
1010011101110101
1000110110101001