1100101000110101
1000000000000001
1001101000100101
1101000010101101
1010110101001001
1010100101110101
1110101111000001
1010001011101001
1011010001000101
1110000110110101
1000110110010001
1011000011101001
1000010110110101
1111110000111001
1010011110001101
1000110111100011