A0000001111111111111
11111101111111111111
11111101111111111111
11111101111111111111
11111101111111111111
11111101111111111111
11111101111111111111
11111101111111111111
11111101111111111111
11111101111111111111
11111101111111111111
11111101111111111111
11111101111111111111
11111101111111111111
11111101111111111111
11111101111111111111
11111101111111111111
11111101111111111111
11111101111111111111
1111110000000000000B